{
  "rows": 5,
  "columns": 20,
  "tileSize": 16,
  "tiles": [
    "11188888881118888881",
    "18800000008880000001",
    "10000020000001111111",
    "12222212000220000001",
    "11111111222111111111"
  ]
}