{
  "rows": 5,
  "columns": 20,
  "tileSize": 32,
  "tiles": [
    "11111111111111111111",
    "11100000001110000001",
    "10000010000001111111",
    "11111111000110000001",
    "11111111111111111111"
  ]
}