{
  "rows": 5,
  "columns": 20,
  "tileSize": 16,
  "tiles": [
    "11111111111111111111",
    "11100000000000000001",
    "10000000000001111111",
    "11111111000000000001",
    "11111111111111111111"
  ]
}